2019_ADHD_PGC_Hook_ATAC.cell_type_results.txt	ADHD
2019_Alz_Marioni_Hook_ATAC.cell_type_results.txt	Alzheimers
2019_BMI-GIANT-2015_Hook_ATAC.cell_type_results.txt	BMI
2019_Epilepsy_All_Hook_ATAC.cell_type_results.txt	Epilepsy - all
2019_Epilepsy_Focal_Hook_ATAC.cell_type_results.txt	Epilepsy - focal
2019_Epilepsy_GGE_Hook_ATAC.cell_type_results.txt	Epilepsy - GGE
2019_final.SZ-CLOZUK_Hook_ATAC.cell_type_results.txt	Schizophrenia - CLOZUK
2019_Height-GIANT_Hook_ATAC.cell_type_results.txt	Height
2019_insomnia-2018_Hook_ATAC.cell_type_results.txt	Insomnia
2019_Intelligence-2018_Hook_ATAC.cell_type_results.txt	Education Years
2019_MDD-2018_Hook_ATAC.cell_type_results.txt	MDD
2019_munged_BDSCZvsCONT_Hook_ATAC.cell_type_results.txt	Bipolar-SZ vs. controls
2019_munged_BDvsCONT_Hook_ATAC.cell_type_results.txt	Bipolar disease
2019_munged_blood_EOSINOPHIL_COUNT_Hook_ATAC.cell_type_results.txt	Eosinophil count
2019_munged_blood_HIGH_LIGHT_SCATTER_RETICULOCYTE_COUNT_Hook_ATAC.cell_type_results.txt	Hight light	scatter reticulocyte count
2019_munged_blood_LYMPHOCYTE_COUNT_Hook_ATAC.cell_type_results.txt	Lymphocyte count
2019_munged_blood_MEAN_SPHERED_CELL_VOL_Hook_ATAC.cell_type_results.txt	Mean sphered cell volume
2019_munged_blood_MONOCYTE_COUNT_Hook_ATAC.cell_type_results.txt	Monocyte count
2019_munged_blood_RBC_DISTRIB_WIDTH_Hook_ATAC.cell_type_results.txt RBC distribution width
2019_munged_blood_WHITE_COUNT_Hook_ATAC.cell_type_results.txt	White count
2019_munged_body_BALDING1_Hook_ATAC.cell_type_results.txt	Balding-1
2019_munged_body_BALDING4_Hook_ATAC.cell_type_results.txt	Balding-4
2019_munged_body_WHRadjBMIz_Hook_ATAC.cell_type_results.txt	WHRadjBMIz
2019_munged_bp_DIASTOLICadjMEDz_Hook_ATAC.cell_type_results.txt	Diastolic adjustedMEDz
2019_munged_bp_SYSTOLICadjMEDz_Hook_ATAC.cell_type_results.txt	Systolic adjustedMEDz
2019_munged_cov_SMOKING_STATUS_Hook_ATAC.cell_type_results.txt	Smoking status
2019_munged_disease_AID_ALL_Hook_ATAC.cell_type_results.txt		AID - all
2019_munged_disease_ALLERGY_ECZEMA_DIAGNOSED_Hook_ATAC.cell_type_results.txt	Allergy eczema diagnosed
2019_munged_disease_ASTHMA_DIAGNOSED_Hook_ATAC.cell_type_results.txt	Asthma diagnosed
2019_munged_disease_CARDIOVASCULAR_Hook_ATAC.cell_type_results.txt	Cardiovascular disease
2019_munged_disease_HI_CHOL_SELF_REP_Hook_ATAC.cell_type_results.txt	High cholesterol - self reported
2019_munged_disease_THYROID_ANY_SELF_REP_Hook_ATAC.cell_type_results.txt	Any thyroid disease - self reported
2019_munged_impedance_BASAL_METABOLIC_RATEz_Hook_ATAC.cell_type_results.txt	Basal metabolic rate
2019_munged_lung_FEV1FVCzSMOKE_Hook_ATAC.cell_type_results.txt	FEV1FVCzSMOKE
2019_munged_lung_FVCzSMOKE_Hook_ATAC.cell_type_results.txt	FVCzSMOKE
2019_munged_other_MORNINGPERSON_Hook_ATAC.cell_type_results.txt	Morning person
2019_munged_pigment_SUNBURN_Hook_ATAC.cell_type_results.txt	Sunburn
2019_munged_repro_AgeFirstBirth_Female_Hook_ATAC.cell_type_results.txt	Female age at first birth
2019_munged_repro_MENARCHE_AGE_Hook_ATAC.cell_type_results.txt	Menarche age
2019_munged_repro_MENOPAUSE_AGE_Hook_ATAC.cell_type_results.txt	Menopause age
2019_munged_repro_NumberChildrenEverBorn_Pooled_Hook_ATAC.cell_type_results.txt	Number of children ever born
2019_munged_SZvsBD_Hook_ATAC.cell_type_results.txt	SZvsBD
2019_munged_SZvsCONT_Hook_ATAC.cell_type_results.txt	SZvsCont
2019_Neurot-Nagel_Hook_ATAC.cell_type_results.txt	Neuroticism
2019_PASS_Anorexia.sumstats_Hook_ATAC.cell_type_results.txt	Anorexia
2019_PASS_Autism.sumstats_Hook_ATAC.cell_type_results.txt	Autism
2019_PASS_Celiac.sumstats_Hook_ATAC.cell_type_results.txt	Celiacs disease
2019_PASS_Coronary_Artery_Disease.sumstats_Hook_ATAC.cell_type_results.txt Coronary artery disease
2019_PASS_Crohns_Disease.sumstats_Hook_ATAC.cell_type_results.txt	Crohns disease
2019_PASS_DS.sumstats_Hook_ATAC.cell_type_results.txt	DS
2019_PASS_Ever_Smoked.sumstats_Hook_ATAC.cell_type_results.txt	Ever smoked
2019_PASS_Fasting_Glucose.sumstats_Hook_ATAC.cell_type_results.txt	Fasting glucose
2019_PASS_HDL.sumstats_Hook_ATAC.cell_type_results.txt	HDL
2019_PASS_IBD.sumstats_Hook_ATAC.cell_type_results.txt	IBD
2019_PASS_LDL.sumstats_Hook_ATAC.cell_type_results.txt	LDL
2019_PASS_Lupus.sumstats_Hook_ATAC.cell_type_results.txt	Lupus
2019_PASS_Multiple_sclerosis.sumstats_Hook_ATAC.cell_type_results.txt	Multiple sclerosis
2019_PASS_Primary_biliary_cirrhosis.sumstats_Hook_ATAC.cell_type_results.txt	Primary biliary cirrhosis
2019_PASS_Rheumatoid_Arthritis.sumstats_Hook_ATAC.cell_type_results.txt	Rheumatoid arthritis
2019_PASS_SWB.sumstats_Hook_ATAC.cell_type_results.txt	Self well-being
2019_PASS_Triglycerides.sumstats_Hook_ATAC.cell_type_results.txt	Triglycerides
2019_PASS_Type_1_Diabetes.sumstats_Hook_ATAC.cell_type_results.txt	Type 1 Diabetes
2019_PASS_Type_2_Diabetes.sumstats_Hook_ATAC.cell_type_results.txt	Type 2 Diabetes
2019_PASS_Ulcerative_Colitis.sumstats_Hook_ATAC.cell_type_results.txt	Ulcerative colitis