CD4 T-cells human	final_CD4-summits_corces_hg19_summits	T-cells
CD8 T-cells human	final_CD8-summits_corces_hg19_summits	T-cells
Microglia	summits_filter2_adult_microglia_merged_GSE79816_summits	Glia
Astrocytes*	summits_filter2_astrocytes_merge_preissl_summits	Glia
Cones (blue)	summits_filter2_blue-cone_ss-all_merge_GSE83312_summits	Retina cells
CD4 T-cells	summits_filter2_cd4_mm10_merged_GSE107076_summits	T-cells
CD8 T-cells	summits_filter2_cd8_mm10_merged_GSE107076_summits	T-cells
Excitatory Camk2a	summits_filter2_cort_excite_merge_GSE63137_summits	Excitatory neurons
Inhibitory PV	summits_filter2_cort_pv-gaba_merge_GSE63137_summits	Inhibitory neurons
Inhibitory VIP	summits_filter2_cort_vip-gaba_merge_GSE63137_summits	Inhibitory neurons
Excitatory Layers II-III	summits_filter2_cux2_excite_merge_GSE87548_summits	Excitatory neurons
Excitatory Layer VI*	summits_filter2_ex1_merge_preissl_summits	Excitatory neurons
Excitatory DG*	summits_filter2_ex2_merge_preissl_summits	Excitatory neurons
Excitatory Layers II-V*	summits_filter2_ex3_merge_preissl_summits	Excitatory neurons
Embryonic DA forebrain	summits_filter2_fb_da_all_merge_mccallion_summits	Dopaminergic neurons
Inhibitory Gad2	summits_filter2_gad2_inhib_merge_GSE87548_summits	Inhibitory neurons
Cones (green)	summits_filter2_green-cone_all_merge_GSE83312_summits	Retina cells
Inhibitory*	summits_filter2_inhib1_merge_preissl_summits	Inhibitory neurons
Inhibitory MSN*	summits_filter2_inhib2_merge_preissl_summits	Inhibitory neurons
Embryonic DA midbrain	summits_filter2_mb_da_all_merge_mccallion_summits	Dopaminergic neurons
Microglia*	summits_filter2_microglia_merge_preissl_summits	Glia
NeuN negative	summits_filter2_neun-neg_merge_preissl_summits	Glia
Excitatory Layer VI	summits_filter2_ntsr1-6_excite_merge_GSE87548_summits	Excitatory neurons
Oligodendrocytes*	summits_filter2_oligo_merge_preissl_summits	Glia
Excitatory Layer V	summits_filter2_rbp4-5_excite_merge_GSE87548_summits	Excitatory neurons
Rods	summits_filter2_rod_ss-all_merge_GSE83312_summits	Retina cells
Excitatory Layer IV	summits_filter2_scnn1a-4_excite_merge_GSE87548_summits	Excitatory neurons